    #####
    #   #
    # $ #
###  $##
#  $  #
## ###  ######
#   #  ##    #
# $  $  #    #
###### ##    #
    #   ######
    #### 